---------------------------------------------------------------------------------------------------------------------------------------------------------------------
---------------------------------------------------------------------------------------------------------------------------------------------------------------------
---------------------------------------------------------------------------------------------------------------------------------------------------------------------
-----------------------------------oooE--------------------------------ooooo-----------------------------------------------------------------------------------------
--------------------------XXX-----XXXXXXX-----------------------------XXXXXXX------------------XXX------XXXXXX---?------------------XXX------------------XXX---------
--------------------XXX-----------------------------------E------------------------XXX-----------------------------------------------------------XXXX----------------
------------------------------------------------------------------------------------------------------------------------------XXX------------------------------------
----------------o------------------------------------------------------------------o-o-------------------------E--------oEoo-----------------------------------------
---------------XXX--------XXX-----------------------------------XXX----------------o-o-XXX----------XX-------XXXXX-----XXXXXX----------------------------------------
------------------------------------------------------------XX-----------------------------------------------------------------------------XXX-----------------------
--------------------------------------------E--E---------------------------------------------------------------------------------------------------------------------
-----------------------------------------XXXXXXXXX----XXX-------------------------------------E---------------------------------------------------------------------X
XXXXXXXXXXX--------------------------------------------------------------------------------XXXXXXX------------------------------------------------------------XXXXXXX
XXXXXXXXXXXXXXXXXXXXXXXXXXXXX---XXXXXXXXXXXXXXXXXXXXXXXXXXXXXXXXXXXXXXXXXXXXX----XXXXXXXXXXXXXXXXXXXXXXXXXXXXXXXXXXXX---XXXXXXXXXXXXXXXXXXXXXXXXXXXXXXXXXXXXXXXXXXXXX
