------------------------------------------------------------------------------------------------------------------------------------------------------------------------------------
------------------------------------------------------------------------------------------------------------------------------------------------------------------------------------
------------------------------------------------------------------------------------------------------------------------------------------------------------------------------------
------------------------------------------------------------------------------------------------------------------------------------------------------------------------------------
----------------------------------------------------------------------------------oo---------------------------------o-o---------ooooo-----XXX----ooo-------------------------------
--------------------------------------XXX-----------------------------------------------------------------------XXX-------------XXXXXXX------------------------------------X--------
-------------------------XXXoo-------------------XXX--------------------------------------------------------------------------------------------------------------------------------
--------------------------------X---------------------------------------------------------------------------------------------------------------------------------------------------
-------------------------------------------------------E----------------ooooo------------------------E------------------------------------------------------------------------------
--------------------------------------------XXX-------XXXXX------------XXXXXXX-------?--------------XXXX---XXX-------XXX----------------------------------------------X-------------
------------------------------------------------------------------------------------------------------------------------------------------------------------------------------------
------------------------------------------------------------------------------------------------------------------------------------------------------------------------------------
---------------------------------------------------------------------------------------------------------------------------------------E--------------------------------------------
XXXXXXXXXXX-----XXXXXXXXXXXXXXXXXXXXXXXXXXXXXXXXXXXXXXXXXXXXXXXXXXXXXXXXXXXXXXXX-XXX----XXXXXXXXXX----XXXXXXXXXXXXXXXXXXXXXXXXXXXXXXXXXXXXX----XXXXXXXXXXXXXXXXXXX---XXXXXXXXXXXXXXX