-----------------------------------------------------------------------------------------------------------------------------------------------------------------------------------------------------------------------------------------------------------------
-----------------------------------------------------------------------------------------------------------------------------------------------------------------------------------------------------------------------------------------------------------------
------------------------------------------------------------------------------------------------------------------------------------------------------------------------------------------E----------------------------------------------------------------------
-----------------------------------------------------------------------------------------------------------------------------------------------------------------------------------------<>----------------------------------------------------------------------
-----------------------------------------------------------------------------------------------------------------------------------------------------------------------------------------[]----------------------------------------------------------------------
------------------------------------------------------------------------------------------------------------------------------------------------------------------------?-----------S----XX------------------------------------------------------------XX--------
------------------------------------------------------------------------------------------------------------------------S--------------------------oooo-----------------------------------------------------------------------------------------------XXX--------
--------------------------------------------------------------------------------------------oooooo-------------------------------------------------------------------------------------------------------------------------------------E-------------XXXX--------
------------------------------------ooo--------------------oooo-------------------------------------------------------------------------ooo-----------------------------o------------S-------------------oo-----------------------------XXX------X--XXXXX--------
---------------E-----------------------------------E-----------------------------XX----------------------------------------------------------------------------------E--S--------------------------------------------------------------------------XXXXXX--------
--------------<>----------------------------------<>-----------------------------XXX--------------------------------------------------------------------------------<>---------------------------------------X-------E----------------------------XXXXXXX--------
--------------[]-----------------------------X----[]-----------------------------XXXX-------E---------------------------X-------------------------------------------[]---X----<>-----------------X-----------X------<>---------------------------XXXXXXXX--------
--------------[]---E--------E----E-E---------XX---[]------EE----------------X----XXXXX-----<>-----XX---EE-----------X---X-------E--EE-E-----EE-----------E-EE-------[]E--X----[]---E-------------X----EE-----X------[]-----E-----EE-------------XXXXXXXXX--------
XXXXXXXXXXXXXXXXXXXXX<>XXXX<>XXXXXXXXXXX-----XXX--[]XXXXXXXXXXXXXXXXXXXXXXXXX----XXXXXX----[]------XXXXXXXXXXXXXXXXXX---X--XXXXXXXXXXXXXXXXXXXXXXXXXXXXXXXXXXXXXXXXXXXXXXX----XXXXXXXXX---XXXXXXXXXXXXXXXXXXXXXXXXXXXX--XXXXXXXXXXXXXXX---XXXXXXXXXXXXXXXXXXXXXXX