--------------------------------------------------------------------------------------------------------------------------------------------------------------------------------------
---------------------------------------------------E-------------------------------------------?--------------------------------------------------------------------------------------
--------------------------------------------------<>-------------------------ooo------------------------------------------------------------------------------------------------------
--------------------E-----------------------------[]-------------------------ooo------------------------------------------------------------------------------------------------------
--------------XXXXXXXXXXX-----------------------XX[]X------------XXX--------XXXX--------------XXXX--o---------------------------------------------------SS----X---XX-----XXX----------
----------------------------------------------------------------------------------------------------o---------------------------------------------------------------------------------
------------------------------------------------------XXX---------------------------XXX---------------XXX-------------------------------------------------------ooooooo---------------
-------------------E-----------------------------------------------------------------------------------------------------------------------------------oooo-----ooooooo---------------
-----------XXXXXXXXXXXXXXXX---------------XEXXX-----------------------------------------------------------------XXXEXX-----XXXX---------------XXX------XXXX-----------E---------------
----------------------------------------------------------------------E-----E--------------------------------------------E-----------XXX-----E-----------------------<>---------------
--------XXX----------------------------------------------------------<>----<>---------------------XXX---------------------------------------<>------------------E----[]---------------
-------------------------------E-----E---------------------XXX-------[]----[]---------------------------------------------------------------[]-----------------<>----[]--------------X
XXXXXXXXXXX---------------XXXXXXXXXXXXXXXX--------------------------X[]X--X[]XXXXX-------XXEX--------------XXXXX----------------------------[]-----------------[]----[]-------------XX
XXXXXXXXXXXXXXXXXXXXXXXXXXXXXXXXXXXXXXXXXXXXXXXXXXXXXXXXXXXXXXXXXXXXXXXXXXXXXXXXXXXXXXXXXXXXXXXXXXXXXXXXXXXXXXXXXXXXXXXXXXXXXXXXXXXXXXXXXXXXXXXXXXXXXXXXXXXXXXXXXXXXXXXXXXXXXXXXXXXXXX