-----------------------------------------------------------------------------------------------------------------------------------------------------------------------------------------------------------------
-----------------------------------------------------------------------------------------------------------------------------------------------------------------------------------------------------------------
---------------SS-------------------XXXX-------------------------------------------------------------------------------------------------------------------------------------------------------------------------
---------------[]--------------------[]--------------------------------------------------------------------------------------------------------------------------------------------------------------------------
---------------[]--------------------[]--------------------------------------------------------------------------------------------------------------------------------------------------------------------------
---------------<>--------------------[]------------------------------------------XX--------------SSSS-----------------------------------------------SSSSS-----SSSSS---------X----E-------------------------------
-------------------------------------[]------------------------------------------[]---------------[]-----------------------------------------------S-----------[]---------------<>-------------------------------
----------------E--------------------[]------------------------------------------[]---------------[]----------------------------------------------SS-----------[]---------------[]-----------------E-------------
---------------E---------------------[]------------------------------------------[]---------------[]---------------------------------------------SSS-------?---[]---------E-----[]----------------<>-------------
--------------<>---QQQQQQ?QQQQQQQ?Q--<>------------------------------------------[]---------------[]-----------------------S---S----------------SSSS-----------<>--------<>-----[]------------?---[]-------------
--------------[]-----------------------------------------------------------------<>-----B---------<>-----------E---------------------------------------------------------[]-----[]----------------[]-------------
--------------[]--------------------------E---------------------------------------------b---------------------<>-X-X---------------------E----------------------E--------[]-----[]----------------[]-------------
--------------[]-----------------------------E--------------------X---------------E-----B----------E----------[]-X-X--------------------E-------B------------B-----------[]-----[]------E---------[]------------X
XXXXXXXXXXXXXXXXXXXXXXXXXXXXXXXXXXXXXXXXXXXXXXX-----XXXXXXXXXXXXXXX---XXXXXXXXXXXXXXXXXXXXXXXXXXXXXXXXXXXXXXXXXXXXXX----XXXXXXXXXXXXXXX<>XXXXXXXXXXXXXXXXXXXXX-XXXXXXXXXXXX-----XXXXXXX<>XXXXXX---XXXXXXX-------X