---------------------------------------------------------------------------------------------------------------------------------------------------------------------------------------
---------------------------------------------------------------------------------------------------------------------------------------------------------------------------------------
---------------------------------------------------------------------------------------------------------------------------------------------------------------------------------------
---------------------------------------------------------------------------------------------------------------------------------------------------------------------------------------
-----------------------------------------------------oooooooo--E------------------E----------------------------------------------------------------------------------------------------
---------------------------------------------------SSSSSSSSSSSSSS---SSSS-SSSSSSSSSSSSS----------------------------------SSSSSS-----------------E-----------------------------XX--------
----------------------------------------------------------------------------------------------------------------------E-----------------------<>----------------------------XXX--------
----------------------------------------------------------------------------------------------------------------------------------------------[]---------------------------XXXX--------
---------------E-X-----------------E--?-------------------------------------------E------X-----------------------------E------------------E---[]--------------------------XXXXX--------
------------XSS?SX---QQ?QQ--------<>-----------------?SSSSSSSSSS--X---------------QQ?QQQQX----------------------------<>---<>------------<>--QQQ?------------------------XXXXXX--------
----------------------------------[]-----------------------------XX---------------------------------------------------[]---[]------------[]--------------------E--------XXXXXXX--------
----------------------------------[]----------------------------XXX---------------------------------------------------[]---[]------------[]-------------------<>-------XXXXXXXX--------
----------------------------E-----[]-----E-E---------------E---XXXX-----------X---EE-------------EE-----------EE-E----[]---[]------------[]------E--------E---[]----E-XXXXXXXXX--------
XXXXXXXXXXXXXXXXXXXXXXXXXXX<>XXXXXXXXXXX<>XXXXXX---XXXXXXXXXXXXXXXXXXXX-------XXXXXXXXXXXXXXXXXX--XXXXXXXXXXXXXXXXXXXXXX---XX--XXXXXXXXXXXXX-----X---XXXXXXXXXXXXXXXXXXXXXXXXXXXXXXXXXX
